2,2,2,2,2,2,2,2,2,2,2,2,2,2,2,2
2,0,0,0,0,0,0,0,0,0,0,0,0,0,0,2
2,0,0,0,0,0,0,0,0,0,0,0,0,0,0,2
2,0,0,0,0,0,0,7,7,0,0,0,0,0,0,2
2,0,0,0,2,2,2,2,2,2,2,2,0,0,0,2
2,7,0,0,0,0,0,0,0,0,0,2,0,0,0,2
2,2,7,0,0,0,0,0,7,7,0,2,0,0,0,2
2,2,2,2,2,0,0,0,2,2,2,2,0,0,0,2
2,0,0,0,0,0,0,0,2,0,0,0,0,0,0,2
0,0,0,0,0,0,2,2,2,2,2,2,7,7,0,9
0,8,0,0,0,7,2,2,2,2,2,2,2,2,0,9
2,2,2,2,2,2,2,2,2,2,2,2,2,2,2,2